############
#        O #
#   P   ####
#          #
#######    #
#  O ##  x #
#    ##    #
#          #
#  x    #  #
#       #  #
############
