################################################
#                                              #
#                                              #
#                                              #
#                                              #
#                  P  X  O                     #
#                                              #
#                                              #
#                                              #
#                                              #
#                                              #
#                                              #
#                                              #
#                                              #
################################################
